00 00 00 00 00 00 00 00 00 00 98 00 00 00 00 00 00 00 00 00
00 00 99 00 00 00 00 00 00 00 00 00 00 00 00 00 00 00 00 00
00 00 49 00 00 00 00 00 00 00 00 00 00 00 00 00 00 00 00 00
00 00 00 00 00 00 00 00 00 00 98 00 00 00 00 00 00 00 00 00
00 00 00 00 00 00 25 05 29 00 00 00 00 00 00 00 00 00 00 00
00 00 00 00 00 00 00 00 00 00 00 00 00 00 00 00 00 00 00 00
00 00 00 00 00 00 00 00 00 00 00 00 00 46 48 00 00 00 00 00
00 00 00 00 00 00 00 00 00 00 00 00 00 00 00 00 00 46 48 00
00 00 00 00 00 00 00 00 00 00 00 00 00 00 00 00 00 00 00 00
00 00 00 00 00 00 98 98 98 00 00 00 00 00 00 00 00 00 00 00
05 05 05 05 05 05 05 05 05 05 05 05 05 05 05 05 05 05 05 05
00 00 00 00 00 00 00 00 00 00 00 00 00 00 00 00 00 00 00 00