00 00 00 00 00 00 00 00 00 00 98 00 00 00 00 00 00 00 00 00
00 00 69 00 00 00 00 00 00 00 00 00 00 00 00 00 00 00 00 00
00 00 25 29 00 00 00 00 00 00 00 00 00 00 00 00 00 00 00 00
00 00 00 00 00 00 00 00 00 00 98 00 00 00 00 00 00 00 00 00
00 00 00 00 00 00 25 05 29 00 00 00 00 00 00 00 00 00 00 00
00 00 00 00 00 00 00 00 00 00 00 00 00 00 00 00 00 00 00 00
00 00 00 00 00 00 00 00 00 00 00 00 00 46 48 00 00 00 00 00
00 00 00 00 00 00 00 00 00 00 00 00 00 00 00 00 00 46 48 00
00 00 00 00 00 00 00 00 00 00 00 00 00 00 00 00 00 00 00 00
00 00 00 00 00 00 98 98 98 00 00 00 00 00 00 00 00 00 00 00
25 05 05 05 05 05 05 05 05 05 05 05 05 05 05 05 05 05 05 29
00 00 00 00 00 00 00 00 00 00 00 00 00 00 00 00 00 00 00 00
20 120