00 00 00 00 33 54 54 54 54 36 00 00 00 00 00 00 00 00 00 00 00 00 00
00 00 00 00 55 00 00 00 00 55 00 00 00 00 00 00 00 00 00 00 00 00 00
00 00 00 00 55 00 00 00 00 55 00 00 00 00 00 00 00 00 00 00 00 00 00
00 00 00 00 34 54 48 00 00 47 00 00 00 00 45 00 00 00 00 00 00 00 00
00 00 00 00 00 00 00 00 00 00 00 00 00 00 55 00 00 00 00 00 00 00 00
00 00 00 00 00 00 00 00 00 00 00 00 00 00 55 00 00 00 00 00 00 00 00
00 00 00 00 45 00 00 00 00 00 00 00 00 00 55 00 00 00 00 00 00 00 00
00 00 00 00 55 56 00 00 00 00 00 00 00 00 55 00 00 00 00 00 00 00 00
98 00 00 00 55 00 00 00 00 00 00 00 00 00 55 00 00 00 00 00 00 00 00
46 48 00 00 55 00 00 00 00 00 56 00 00 00 55 00 00 00 00 00 00 00 00
00 00 00 98 55 98 98 00 00 00 00 98 98 98 55 00 00 00 00 00 00 00 00
00 00 00 00 34 54 54 54 54 54 54 54 54 54 35 00 00 00 00 00 00 00 00
00 00 00 00 00 00 00 00 00 00 00 00 00 00 00 00 00 00 00 00 00 00 00
00 00 00 00 00 00 00 00 00 00 00 00 00 00 00 00 00 00 00 00 00 00 00
00 00 00 00 00 00 00 00 00 00 00 00 00 00 00 00 00 00 00 00 00 00 00
00 00 33 29 60 60 49 60 60 49 60 60 25 36 00 00 00 00 00 00 00 00 00
00 00 34 08 08 08 08 08 08 08 08 08 08 35 00 00 00 00 00 00 00 00 00
00 00 00 00 00 00 00 00 00 00 00 00 00 00 00 00 00 00 00 00 00 00 00
00 00 00 00 00 00 00 00 00 00 00 00 00 00 00 00 00 00 00 00 00 00 00
00 00 00 00 00 00 00 00 00 00 00 00 00 00 00 00 00 00 00 00 69 00 00
00 00 00 00 00 00 00 00 00 00 00 00 00 00 00 00 00 00 00 00 46 48 00
00 00 00 00 00 00 00 00 00 00 00 00 00 00 00 00 00 00 00 00 00 00 00
00 00 00 00 00 00 00 00 00 00 00 00 00 00 00 00 00 00 00 00 00 00 00
180 40