00 00 00 00 00 00 00 00 00 00 00 00 00 00 00 00 00 00 00 00
00 00 00 00 00 00 00 00 00 00 45 00 00 00 00 00 00 00 00 00
00 00 00 00 00 00 00 00 00 00 55 00 00 00 00 00 00 00 00 00
00 00 00 00 00 00 00 00 00 00 55 00 00 00 00 00 00 00 00 00
00 00 00 00 00 00 00 00 00 00 55 00 00 00 45 00 00 00 00 00
00 00 00 00 00 00 00 00 00 00 47 00 00 00 55 00 00 00 00 00
00 00 00 98 00 00 00 00 00 00 00 00 00 00 55 00 00 00 00 00
00 00 00 00 00 00 69 00 00 00 00 00 00 00 34 48 00 00 00 00
00 00 00 00 00 00 46 48 00 00 00 00 00 00 00 00 00 46 54 48
00 00 00 98 46 48 00 00 00 00 00 98 00 98 00 00 00 00 00 00
00 00 00 00 00 00 00 00 00 00 00 00 00 00 00 00 00 00 00 00
00 45 00 00 00 00 00 00 00 00 00 00 00 00 00 00 00 00 00 00
46 08 54 48 00 00 56 00 00 46 54 54 48 00 00 00 00 00 00 00
560 224