00 00 00 00 00 00 00 00 00 00 00 00 00 00 00 00 00 00 00 00 00 00 00 00 00 00 00 00 00 00 00 00 00
00 00 00 00 00 00 00 00 00 00 00 00 00 00 00 00 00 00 00 00 00 98 00 00 98 00 00 98 00 98 60 60 60
00 00 00 00 00 00 00 00 59 29 00 00 00 00 00 33 05 05 05 05 48 00 00 00 00 59 36 00 00 00 06 53 07
00 00 00 00 00 98 00 00 00 00 00 00 00 00 00 06 39 08 08 35 98 00 00 00 00 00 47 00 00 00 34 08 35
00 00 00 00 25 29 00 00 00 00 00 00 00 00 00 06 07 00 00 00 00 00 00 00 00 00 00 00 00 00 00 00 00
00 00 00 00 00 00 00 00 00 00 00 00 00 00 00 06 35 00 00 00 00 00 00 00 00 00 00 00 00 00 00 00 00
00 00 00 00 00 00 00 00 25 29 00 00 00 00 00 55 98 00 00 33 05 57 00 00 00 59 36 00 00 00 33 05 36
00 00 00 00 00 00 00 00 00 00 00 00 00 00 00 47 00 00 00 34 08 57 98 98 98 59 35 00 00 00 06 53 07
00 00 00 00 00 00 00 00 00 00 00 00 00 00 00 00 00 00 00 00 00 00 00 00 00 00 00 00 00 00 06 53 07 00 69
00 00 00 25 29 00 00 00 00 00 00 00 00 00 00 00 56 00 00 00 00 00 00 00 00 00 00 00 00 00 06 53 07 00 46 48
00 00 00 00 00 00 00 00 00 25 29 00 00 00 00 00 00 00 00 98 00 00 00 00 00 98 00 00 00 00 06 53 07
00 00 00 00 00 00 00 00 00 00 00 00 00 00 00 00 00 00 46 54 48 00 00 56 00 00 00 33 05 05 37 53 07
00 00 00 00 00 00 25 29 00 00 00 00 00 00 00 00 00 00 00 00 00 00 00 00 00 00 00 06 53 53 53 53 07
00 00 00 00 00 00 00 00 00 00 00 00 00 00 00 00 00 00 00 00 00 00 00 00 00 00 00 34 08 08 08 08 35
00 00 00 00 00 00 00 00 00 00 00 00 00 00 00 00 00 00 00 00 00 00 00 45 00 00 00 00 00 00 00 00 00
00 00 00 00 00 00 00 00 00 00 00 00 00 00 00 00 00 00 00 00 00 00 46 35 00 00 00 00 00 00 00 00 00
200 300