00 00 00 00 00 00 00 00 00 00 00 00 00 00 00 00 00 00 00 00
00 00 60 60 60 60 60 60 25 05 36 00 00 60 60 00 00 00 00 00
00 00 34 08 08 08 08 08 08 53 07 00 00 58 47 00 00 00 00 00
00 00 00 00 98 00 00 00 00 58 55 00 00 00 00 00 00 00 00 00
00 00 00 00 00 00 00 00 00 00 55 00 00 00 00 00 00 00 00 00
00 00 00 00 00 00 00 00 00 00 55 00 00 00 00 00 00 00 00 00
00 00 00 00 98 00 00 00 00 00 55 60 60 45 00 00 00 00 00 00
00 00 46 48 00 00 00 00 00 00 34 08 08 35 98 98 00 98 46 48
00 00 00 00 00 56 00 00 00 00 00 00 00 00 00 00 00 00 00 00
00 00 00 00 00 00 00 00 56 00 00 00 00 00 00 00 00 00 00 00
00 00 69 00 00 00 00 00 00 00 00 00 00 00 00 00 00 00 00 00
00 00 25 29 00 00 00 00 00 00 00 60 36 00 00 25 29 00 00 00
00 00 00 00 00 00 00 00 56 00 00 34 35 00 00 00 00 00 00 00
00 00 00 00 00 00 00 00 00 00 00 00 00 00 00 00 00 00 00 00
280 0