00
00 00 00 00 00 00 00 00 00 00 00 00 00 00 00 00 49 98 98 98 00 00 00 00 00 00 00 00 00 00 00 00 00 00 00 00 00 00 00 00 00 00 00 98
00
00 00 00 00 00 00 00 00 00 00 00 00 00 00 00 00 00 00 00 00 00 00 98 00 00 00 00 00 00 00 00 00 00 00 00 00 00 00 00 00 00 00 00 00 00 98 98
00 00 00 00 00 00 00 00 00 00 00 00 00 00 00 00 49 98 98 98 00 00 00 00 00 00 00 00 00 00 00 00 00 00 00 00 00 00 00 00 00 00 00 98 00 00 98
00 00 00 00 00 00 00 00 00 00 00 00 00 00 00 00 00 00 00 00 00 00 98 00 00 00 00 00 00 00 00 00 00 00 00 00 00 00 00 00 00 00 00 98 00 00 98
00 00 00 00 00 00 00 00 00 00 00 00 00 00 00 00 00 00 00 00 00 00 00 00 00 00 00 00 00 00 00 00 00 00 00 00 00 00 00 00 00 98 00 98 00 00 98
00 00 00 00 00 00 60 60 00 00 00 00 00 00 00 00 00 00 00 49 00 00 00 98 00 00 00 00 00 00 00 00 00 00 00 00 00 00 98 98 98 49 00 98 98 00 98
00 00 00 00 00 46 08 08 48 00 00 00 00 00 00 00 00 00 00 00 00 00 00 00 00 00 00 00 00 00 00 00 00 00 00 00 00 00 00 00 00 00 00 98 00 00 98
00 00 00 00 00 00 00 00 00 00 00 00 00 98 00 00 00 00 98 00 00 00 00 98 00 00 00 00 00 00 00 00 00 00 00 00 98 00 00 00 00 00 00 98 00 00 98
46 48 00 00 00 00 00 00 00 00 00 00 00 98 00 00 00 00 00 49 00 00 00 00 00 00 00 00 00 00 00 00 00 00 00 00 59 49 98 98 00 00 00 98 00 00 98
00 00 00 00 00 00 00 00 00 00 00 00 00 98 00 00 00 00 00 00 00 00 00 00 98 00 00 00 00 00 00 00 00 00 00 00 00 00 00 00 00 00 00 98 00 98 98
00 00 00 00 00 00 00 00 00 00 00 00 00 00 00 00 00 00 00 00 00 00 00 00 00 00 00 00 98 00 00 00 98 00 00 00 00 00 00 00 00 00 00 98 00 00 98
00 00 00 00 33 05 05 05 05 36 00 00 00 00 00 00 00 46 54 48 00 00 00 00 00 00 00 50 52 00 00 00 56 00 00 00 56 00 00 46 48 00 00 98 00 00 98
00 00 00 00 34 08 08 08 08 35 00 00 00 00 00 00 00 00 00 00 00 00 00 00 00 00 00 00 00 00 00 00 00 00 00 00 00 00 00 00 00 00 00 98 00 00 98
00 00 00 00 00 00 00 00 00 00 00 00 00 00 00 00 00 00 00 00 00 00 00 00 00 00 00 00 00 00 00 00 00 00 00 00 00 00 00 00 00 00 00 98 98 00 98
00 00 00 00 00 00 00 00 00 00 00 00 00 00 00 00 00 00 00 00 00 00 00 00 00 00 00 00 00 00 00 00 00 00 00 00 00 00 00 00 00 00 00 98 69 00 98
200 300